krona-data/14/Botryosphaeria_dothidea_chrysovirus.csv	krona-data/14/Botryosphaeria_dothidea_chrysovirus.xml
krona-data/14/Cytospora_ribis_mitovirus_1.csv	krona-data/14/Cytospora_ribis_mitovirus_1.xml
krona-data/14/Botrytis_virus_F.csv	krona-data/14/Botrytis_virus_F.xml
krona-data/14/Aspergillus_fumigatus_tetramycovirus_1.csv	krona-data/14/Aspergillus_fumigatus_tetramycovirus_1.xml
krona-data/14/Macrophomina_phaseolina_chrysovirus_1.csv	krona-data/14/Macrophomina_phaseolina_chrysovirus_1.xml
krona-data/14/Grapevine_rupestris_stem_pitting_associated_virus.csv	krona-data/14/Grapevine_rupestris_stem_pitting_associated_virus.xml
krona-data/14/Grapevine_rootstock_stem_lesion_associated_virus.csv	krona-data/14/Grapevine_rootstock_stem_lesion_associated_virus.xml
krona-data/14/Isaria_javanica_chrysovirus_1.csv	krona-data/14/Isaria_javanica_chrysovirus_1.xml
krona-data/14/Grapevine_leafroll_associated_virus_2.csv	krona-data/14/Grapevine_leafroll_associated_virus_2.xml
krona-data/14/Grapevine_associated_chrysovirus_4.csv	krona-data/14/Grapevine_associated_chrysovirus_4.xml
krona-data/14/Grapevine_chrysovirus.csv	krona-data/14/Grapevine_chrysovirus.xml
krona-data/14/Grapevine_satellite_virus.csv	krona-data/14/Grapevine_satellite_virus.xml
krona-data/14/Sclerotinia_sclerotiorum_botybirnavirus_2.csv	krona-data/14/Sclerotinia_sclerotiorum_botybirnavirus_2.xml
krona-data/14/Grapevine_associated_chrysovirus_3.csv	krona-data/14/Grapevine_associated_chrysovirus_3.xml
krona-data/14/Grapevine_partitivirus.csv	krona-data/14/Grapevine_partitivirus.xml
krona-data/14/Gremmeniella_abietina_RNA_virus_6.csv	krona-data/14/Gremmeniella_abietina_RNA_virus_6.xml
krona-data/14/Sclerotinia_sclerotiorum_botybirnavirus_1.csv	krona-data/14/Sclerotinia_sclerotiorum_botybirnavirus_1.xml
krona-data/14/Grapevine_associated_chrysovirus_2.csv	krona-data/14/Grapevine_associated_chrysovirus_2.xml
krona-data/14/Raphanus_sativas_chrysovirus_1.csv	krona-data/14/Raphanus_sativas_chrysovirus_1.xml
krona-data/14/Grapevine_leafroll_associated_virus_1.csv	krona-data/14/Grapevine_leafroll_associated_virus_1.xml
krona-data/14/Red_clover_powdery_mildew_associated_totivirus_4.csv	krona-data/14/Red_clover_powdery_mildew_associated_totivirus_4.xml
krona-data/14/Soybean_leaf_associated_partitivirus_2.csv	krona-data/14/Soybean_leaf_associated_partitivirus_2.xml
krona-data/14/Cryphonectria_nitschkei_chrysovirus_1.csv	krona-data/14/Cryphonectria_nitschkei_chrysovirus_1.xml
krona-data/14/Penicillium_aurantiogriseum_partiti_like_virus.csv	krona-data/14/Penicillium_aurantiogriseum_partiti_like_virus.xml
krona-data/14/Grapevine_virus_A.csv	krona-data/14/Grapevine_virus_A.xml
krona-data/14/Sclerotinia_sclerotiorum_partitivirus_S.csv	krona-data/14/Sclerotinia_sclerotiorum_partitivirus_S.xml
krona-data/14/Fusarium_graminearum_dsRNA_mycovirus_4.csv	krona-data/14/Fusarium_graminearum_dsRNA_mycovirus_4.xml
krona-data/14/Verticillium_dahliae_chrysovirus_1.csv	krona-data/14/Verticillium_dahliae_chrysovirus_1.xml
krona-data/14/Grapevine_leafroll_associated_virus_3.csv	krona-data/14/Grapevine_leafroll_associated_virus_3.xml
krona-data/14/Alternaria_alternata_partitivirus_1.csv	krona-data/14/Alternaria_alternata_partitivirus_1.xml
krona-data/14/Grapevine_associated_chrysovirus_1.csv	krona-data/14/Grapevine_associated_chrysovirus_1.xml
krona-data/14/Botrytis_porri_botybirnavirus_1.csv	krona-data/14/Botrytis_porri_botybirnavirus_1.xml
krona-data/14/Wuhan_insect_virus_30.csv	krona-data/14/Wuhan_insect_virus_30.xml
