krona-data/4/uncultured_totivirus.csv	krona-data/4/uncultured_totivirus.xml
krona-data/4/Soybean_leaf_associated_mycoflexivirus_1.csv	krona-data/4/Soybean_leaf_associated_mycoflexivirus_1.xml
krona-data/4/Xanthophyllomyces_dendrorhous_virus_L1b.csv	krona-data/4/Xanthophyllomyces_dendrorhous_virus_L1b.xml
krona-data/4/dsRNA_virus_environmental_sample.csv	krona-data/4/dsRNA_virus_environmental_sample.xml
krona-data/4/Macrophomina_phaseolina_chrysovirus_1.csv	krona-data/4/Macrophomina_phaseolina_chrysovirus_1.xml
krona-data/4/Aspergillus_fumigatus_tetramycovirus_1.csv	krona-data/4/Aspergillus_fumigatus_tetramycovirus_1.xml
krona-data/4/Red_clover_powdery_mildew_associated_totivirus_4.csv	krona-data/4/Red_clover_powdery_mildew_associated_totivirus_4.xml
krona-data/4/Grapevine_leafroll_associated_virus.csv	krona-data/4/Grapevine_leafroll_associated_virus.xml
krona-data/4/Grapevine_rupestris_stem_pitting_associated_virus_1.csv	krona-data/4/Grapevine_rupestris_stem_pitting_associated_virus_1.xml
krona-data/4/Isaria_javanica_chrysovirus_1.csv	krona-data/4/Isaria_javanica_chrysovirus_1.xml
krona-data/4/uncultured_chrysovirus.csv	krona-data/4/uncultured_chrysovirus.xml
krona-data/4/Grapevine_virus_A.csv	krona-data/4/Grapevine_virus_A.xml
krona-data/4/Grapevine_rupestris_stem_pitting_associated_virus.csv	krona-data/4/Grapevine_rupestris_stem_pitting_associated_virus.xml
krona-data/4/uncultured_endornavirus.csv	krona-data/4/uncultured_endornavirus.xml
krona-data/4/Wuhan_insect_virus_30.csv	krona-data/4/Wuhan_insect_virus_30.xml
krona-data/4/Botrytis_porri_botybirnavirus_1.csv	krona-data/4/Botrytis_porri_botybirnavirus_1.xml
krona-data/4/Grapevine_associated_chrysovirus_1.csv	krona-data/4/Grapevine_associated_chrysovirus_1.xml
krona-data/4/Grapevine_chrysovirus.csv	krona-data/4/Grapevine_chrysovirus.xml
krona-data/4/Wuhan_insect_virus_26.csv	krona-data/4/Wuhan_insect_virus_26.xml
krona-data/4/Grapevine_leafroll_associated_virus_3.csv	krona-data/4/Grapevine_leafroll_associated_virus_3.xml
krona-data/4/Verticillium_dahliae_chrysovirus_1.csv	krona-data/4/Verticillium_dahliae_chrysovirus_1.xml
