krona-data/13/Macrophomina_phaseolina_chrysovirus_1.csv	krona-data/13/Macrophomina_phaseolina_chrysovirus_1.xml
krona-data/13/Aspergillus_fumigatus_tetramycovirus_1.csv	krona-data/13/Aspergillus_fumigatus_tetramycovirus_1.xml
krona-data/13/Wuhan_fly_virus_5.csv	krona-data/13/Wuhan_fly_virus_5.xml
krona-data/13/dsRNA_virus_environmental_sample.csv	krona-data/13/dsRNA_virus_environmental_sample.xml
krona-data/13/uncultured_totivirus.csv	krona-data/13/uncultured_totivirus.xml
krona-data/13/Bovine_viral_diarrhea_virus_1.csv	krona-data/13/Bovine_viral_diarrhea_virus_1.xml
krona-data/13/Cytospora_ribis_mitovirus_1.csv	krona-data/13/Cytospora_ribis_mitovirus_1.xml
krona-data/13/Grapevine_satellite_virus.csv	krona-data/13/Grapevine_satellite_virus.xml
krona-data/13/Grapevine_chrysovirus.csv	krona-data/13/Grapevine_chrysovirus.xml
krona-data/13/Raphanus_sativas_chrysovirus_1.csv	krona-data/13/Raphanus_sativas_chrysovirus_1.xml
krona-data/13/Grapevine_associated_chrysovirus_2.csv	krona-data/13/Grapevine_associated_chrysovirus_2.xml
krona-data/13/Grapevine_associated_chrysovirus_3.csv	krona-data/13/Grapevine_associated_chrysovirus_3.xml
krona-data/13/Grapevine_partitivirus.csv	krona-data/13/Grapevine_partitivirus.xml
krona-data/13/Sclerotinia_sclerotiorum_botybirnavirus_2.csv	krona-data/13/Sclerotinia_sclerotiorum_botybirnavirus_2.xml
krona-data/13/Grapevine_rootstock_stem_lesion_associated_virus.csv	krona-data/13/Grapevine_rootstock_stem_lesion_associated_virus.xml
krona-data/13/uncultured_chrysovirus.csv	krona-data/13/uncultured_chrysovirus.xml
krona-data/13/Grapevine_rupestris_stem_pitting_associated_virus.csv	krona-data/13/Grapevine_rupestris_stem_pitting_associated_virus.xml
krona-data/13/Isaria_javanica_chrysovirus_1.csv	krona-data/13/Isaria_javanica_chrysovirus_1.xml
krona-data/13/Grapevine_leafroll_associated_virus_2.csv	krona-data/13/Grapevine_leafroll_associated_virus_2.xml
krona-data/13/Soybean_leaf_associated_partitivirus_2.csv	krona-data/13/Soybean_leaf_associated_partitivirus_2.xml
krona-data/13/Red_clover_powdery_mildew_associated_totivirus_4.csv	krona-data/13/Red_clover_powdery_mildew_associated_totivirus_4.xml
krona-data/13/Aspergillus_fumigatus_chrysovirus.csv	krona-data/13/Aspergillus_fumigatus_chrysovirus.xml
krona-data/13/Soybean_leaf_associated_mycoflexivirus_1.csv	krona-data/13/Soybean_leaf_associated_mycoflexivirus_1.xml
krona-data/13/Grapevine_leafroll_associated_virus_1.csv	krona-data/13/Grapevine_leafroll_associated_virus_1.xml
krona-data/13/Grapevine_associated_chrysovirus_1.csv	krona-data/13/Grapevine_associated_chrysovirus_1.xml
krona-data/13/Botrytis_porri_botybirnavirus_1.csv	krona-data/13/Botrytis_porri_botybirnavirus_1.xml
krona-data/13/Grapevine_leafroll_associated_virus_3.csv	krona-data/13/Grapevine_leafroll_associated_virus_3.xml
krona-data/13/Alternaria_alternata_partitivirus_1.csv	krona-data/13/Alternaria_alternata_partitivirus_1.xml
krona-data/13/Verticillium_dahliae_chrysovirus_1.csv	krona-data/13/Verticillium_dahliae_chrysovirus_1.xml
krona-data/13/Wuhan_insect_virus_30.csv	krona-data/13/Wuhan_insect_virus_30.xml
krona-data/13/Grapevine_virus_A.csv	krona-data/13/Grapevine_virus_A.xml
krona-data/13/Penicillium_aurantiogriseum_partiti_like_virus.csv	krona-data/13/Penicillium_aurantiogriseum_partiti_like_virus.xml
krona-data/13/Sclerotinia_sclerotiorum_partitivirus_S.csv	krona-data/13/Sclerotinia_sclerotiorum_partitivirus_S.xml
