krona-data/12/Sclerotinia_sclerotiorum_partitivirus_S.csv	krona-data/12/Sclerotinia_sclerotiorum_partitivirus_S.xml
krona-data/12/Isaria_javanica_chrysovirus_1.csv	krona-data/12/Isaria_javanica_chrysovirus_1.xml
krona-data/12/Fusarium_graminearum_dsRNA_mycovirus_4.csv	krona-data/12/Fusarium_graminearum_dsRNA_mycovirus_4.xml
krona-data/12/Botryosphaeria_dothidea_virus_1.csv	krona-data/12/Botryosphaeria_dothidea_virus_1.xml
krona-data/12/Sophora_japonica_powdery_mildew_associated_partitivirus.csv	krona-data/12/Sophora_japonica_powdery_mildew_associated_partitivirus.xml
krona-data/12/Xanthophyllomyces_dendrorhous_virus_L1A.csv	krona-data/12/Xanthophyllomyces_dendrorhous_virus_L1A.xml
krona-data/12/Xinzhou_partiti_like_virus_1.csv	krona-data/12/Xinzhou_partiti_like_virus_1.xml
krona-data/12/Penicillium_aurantiogriseum_partiti_like_virus.csv	krona-data/12/Penicillium_aurantiogriseum_partiti_like_virus.xml
krona-data/12/Grapevine_rupestris_stem_pitting_associated_virus.csv	krona-data/12/Grapevine_rupestris_stem_pitting_associated_virus.xml
krona-data/12/Grapevine_virus_A.csv	krona-data/12/Grapevine_virus_A.xml
krona-data/12/Grapevine_rootstock_stem_lesion_associated_virus.csv	krona-data/12/Grapevine_rootstock_stem_lesion_associated_virus.xml
krona-data/12/Clitocybe_odora_virus.csv	krona-data/12/Clitocybe_odora_virus.xml
krona-data/12/Sclerotinia_sclerotiorum_botybirnavirus_1.csv	krona-data/12/Sclerotinia_sclerotiorum_botybirnavirus_1.xml
krona-data/12/Helminthosporium_victoriae_145S_virus.csv	krona-data/12/Helminthosporium_victoriae_145S_virus.xml
krona-data/12/Gremmeniella_abietina_RNA_virus_MS1.csv	krona-data/12/Gremmeniella_abietina_RNA_virus_MS1.xml
krona-data/12/Grapevine_leafroll_associated_virus_3.csv	krona-data/12/Grapevine_leafroll_associated_virus_3.xml
krona-data/12/Grapevine_satellite_virus.csv	krona-data/12/Grapevine_satellite_virus.xml
krona-data/12/Botrytis_porri_botybirnavirus_1.csv	krona-data/12/Botrytis_porri_botybirnavirus_1.xml
krona-data/12/Grapevine_leafroll_associated_virus_1.csv	krona-data/12/Grapevine_leafroll_associated_virus_1.xml
krona-data/12/Cladosporium_cladosporioides_virus_1.csv	krona-data/12/Cladosporium_cladosporioides_virus_1.xml
krona-data/12/Penicillium_janczewskii_chrysovirus_1.csv	krona-data/12/Penicillium_janczewskii_chrysovirus_1.xml
krona-data/12/Penicillium_chrysogenum_virus.csv	krona-data/12/Penicillium_chrysogenum_virus.xml
